tileWidth = 64
tileHeight = 64
tileset = "basic-64x64.png"
resources = "flatland.res"


layer = {

    16, 24, 27, 13, 31, 27, 21, 19, 21, 19, 13, 20, 28, 23, 28, 28, 20, 22, 19, 18, 26, 30, 13, 21, 13, 13, 16, 28, 31, 13, 17, 31, 26, 14, 26, 27, 13, 28, 16, 21, 29, 18, 15, 26, 18, 31, 27, 16, 16, 30
    13, 28, 28, 20, 13, 21, 22, 19, 19, 24, 22, 20, 25, 17, 30, 26, 27, 30, 19, 20, 27, 21, 29, 26, 25, 24, 21, 25, 18, 25, 15, 21, 13, 22, 14, 14, 18, 23, 26, 24, 23, 24, 21, 31, 25, 27, 18, 26, 29, 16
    31, 28, 31, 30, 19, 29, 16, 23, 20, 20, 22, 27, 14, 30, 20, 19, 26, 15, 28, 18, 14, 16, 31, 28, 16, 16, 18, 15, 15, 18, 27, 24, 21, 14, 13, 14, 24, 14, 28, 26, 30, 31, 15, 19, 29, 23, 24, 17, 16, 30
    26, 24, 17, 13, 19, 14, 19, 18, 31, 24, 13, 30, 29, 23, 14, 28, 15, 31, 13, 28, 29, 30, 15, 13, 16, 31, 30, 26, 22, 15, 21, 17, 18, 28, 23, 29, 14, 26, 13, 13, 26, 23, 15, 23, 25, 18, 14, 31, 18, 27
    19, 29, 13, 30, 13, 13, 17, 20, 25, 27, 15, 29, 27, 16, 31, 25, 20, 18, 29, 16, 28, 26, 17, 20, 31, 29, 27, 13, 31, 20, 15, 20, 19, 25, 14, 14, 26, 20, 17, 21, 31, 25, 24, 24, 27, 31, 20, 31, 23, 13
    25, 15, 26, 26, 24, 24, 24, 13, 25, 24, 20, 30, 15, 25, 24, 31, 15, 20, 20, 15, 24, 19, 24, 19, 25, 29, 29, 25, 19, 16, 25, 26, 24, 30, 23, 21, 15, 20, 16, 19, 22, 17, 22, 26, 27, 25, 29, 27, 23, 26
    20, 21, 22, 25, 24, 15, 25, 14, 18, 22, 22, 24, 30, 29, 13, 13, 15, 17, 13, 22, 29, 25, 27, 14, 26, 18, 29, 27, 21, 18, 21, 20, 22, 29, 18, 26, 28, 22, 24, 27, 30, 19, 19, 15, 26, 24, 28, 18, 29, 15
    13, 29, 14, 17, 21, 15, 23, 28, 22, 27, 27, 19, 16, 14, 28, 14, 14, 24, 22, 14, 26, 26, 22, 13, 15, 19, 16, 24, 29, 23, 27, 28, 19, 22, 14, 14, 22, 26, 16, 26, 27, 20, 25, 16, 14, 18, 24, 20, 16, 21
    15, 29, 19, 27, 14, 13, 17, 22, 29, 29, 26, 14, 27, 23, 29, 13, 19, 24, 22, 22, 28, 26, 22, 25, 27, 30, 29, 28, 25, 30, 14, 24, 19, 15, 29, 28, 18, 25, 18, 28, 17, 25, 30, 31, 26, 17, 17, 24, 21, 31
    27, 19, 29, 29, 17, 16, 15, 27, 18, 17, 16, 28, 28, 21, 29, 28, 25, 14, 18, 20, 31, 13, 22, 23, 16, 25, 23, 14, 18, 25, 27, 26, 30, 31, 14, 23, 20, 31, 30, 26, 13, 29, 13, 30, 22, 22, 24, 19, 28, 21
    17, 26, 31, 20, 24, 21, 16, 14, 30, 14, 29, 14, 18, 20, 13, 22, 25, 26, 17, 21, 25, 21, 13, 24, 25, 14, 13, 21, 21, 23, 24, 23, 13, 24, 27, 30, 21, 25, 19, 23, 21, 16, 31, 17, 24, 26, 17, 22, 14, 28
    25, 18, 13, 31, 22, 19, 31, 18, 17, 28, 14, 13, 20, 28, 30, 19, 21, 19, 28, 17, 28, 26, 24, 16, 31, 26, 15, 18, 16, 28, 25, 30, 22, 19, 31, 16, 30, 16, 13, 16, 14, 23, 22, 28, 19, 25, 15, 29, 20, 22
    26, 20, 17, 16, 15, 19, 22, 24, 23, 31, 23, 20, 13, 17, 31, 15, 16, 18, 13, 15, 31, 22, 19, 27, 31, 20, 27, 29, 22, 23, 29, 26, 20, 17, 29, 14, 27, 26, 17, 22, 18, 23, 27, 14, 25, 23, 21, 14, 20, 29
    19, 23, 27, 14, 19, 27, 25, 18, 29, 23, 16, 27, 14, 14, 31, 13, 26, 28, 20, 22, 13, 22, 14, 30, 29, 15, 13, 19, 19, 23, 20, 29, 28, 24, 13, 23, 29, 25, 24, 16, 13, 30, 30, 13, 23, 28, 30, 17, 22, 24
    30, 27, 27, 15, 26, 25, 31, 17, 24, 31, 18, 25, 18, 26, 14, 14, 23, 15, 20, 28, 17, 21, 26, 27, 17, 14, 29, 24, 27, 21, 20, 29, 19, 19, 20, 14, 24, 19, 16, 27, 15, 22, 21, 27, 22, 13, 30, 26, 17, 19
    19, 19, 16, 19, 16, 31, 24, 27, 27, 28, 26, 13, 17, 15, 28, 28, 28, 18, 31, 28, 20, 16, 27, 18, 14, 30, 29, 13, 24, 31, 26, 23, 18, 29, 25, 29, 31, 24, 19, 24, 15, 23, 13, 15, 16, 25, 30, 24, 18, 22
    27, 19, 15, 22, 20, 14, 14, 28, 14, 29, 15, 31, 19, 25, 18, 27, 25, 20, 29, 16, 19, 27, 21, 16, 28, 13, 18, 29, 31, 29, 24, 25, 28, 13, 23, 13, 18, 17, 16, 24, 14, 14, 14, 20, 31, 15, 14, 24, 13, 28
    25, 16, 20, 24, 31, 17, 24, 15, 26, 15, 27, 16, 13, 19, 30, 28, 27, 29, 16, 29, 23, 23, 18, 15, 27, 24, 21, 28, 27, 24, 30, 20, 13, 23, 15, 24, 31, 21, 26, 23, 30, 20, 26, 25, 22, 22, 15, 20, 15, 14
    25, 29, 30, 24, 15, 30, 24, 30, 30, 31, 29, 25, 23, 29, 20, 17, 29, 27, 15, 29, 27, 18, 23, 31, 21, 27, 23, 14, 17, 24, 14, 25, 13, 28, 16, 16, 26, 24, 18, 14, 30, 26, 17, 21, 17, 23, 24, 19, 18, 23
    24, 26, 19, 25, 28, 25, 24, 23, 23, 31, 17, 28, 18, 30, 15, 24, 14, 30, 13, 14, 26, 25, 30, 29, 18, 24, 13, 21, 30, 21, 20, 16, 23, 29, 15, 25, 19, 13, 28, 30, 26, 25, 17, 31, 25, 27, 28, 25, 16, 16
    29, 20, 28, 28, 21, 24, 24, 13, 15, 24, 20, 21, 16, 19, 26, 22, 13, 22, 16, 14, 18, 28, 29, 14, 30, 24, 24, 30, 14, 18, 22, 15, 22, 23, 27, 23, 21, 20, 14, 24, 15, 17, 28, 13, 20, 14, 26, 17, 15, 31
    21, 22, 16, 13, 17, 23, 24, 15, 15, 25, 18, 21, 27, 20, 13, 16, 17, 27, 25, 23, 22, 14, 18, 24, 23, 28, 15, 23, 19, 30, 21, 18, 21, 24, 15, 28, 24, 27, 13, 30, 15, 13, 24, 21, 15, 30, 31, 15, 19, 22
    17, 19, 20, 25, 29, 18, 20, 24, 27, 25, 24, 25, 14, 29, 15, 18, 20, 21, 27, 20, 31, 13, 29, 24, 17, 31, 29, 26, 29, 29, 19, 21, 25, 19, 23, 29, 20, 20, 13, 14, 29, 31, 14, 21, 20, 24, 27, 14, 18, 20
    28, 23, 18, 15, 25, 18, 17, 25, 27, 22, 28, 29, 13, 13, 20, 30, 25, 22, 18, 25, 31, 21, 13, 28, 24, 24, 24, 26, 23, 29, 19, 22, 23, 31, 19, 19, 24, 17, 28, 18, 17, 18, 24, 17, 14, 17, 27, 22, 30, 24
    19, 27, 26, 30, 15, 21, 23, 14, 27, 31, 27, 27, 22, 22, 15, 28, 22, 19, 21, 26, 24, 31, 30, 18, 17, 23, 15, 20, 18, 15, 29, 18, 21, 26, 27, 25, 19, 23, 23, 21, 19, 25, 20, 22, 15, 30, 30, 27, 19, 20
    26, 30, 14, 22, 26, 29, 18, 14, 20, 26, 13, 24, 16, 29, 17, 16, 26, 16, 22, 22, 25, 30, 30, 25, 20, 31, 15, 25, 19, 16, 21, 23, 30, 19, 20, 14, 14, 21, 23, 16, 16, 24, 26, 17, 20, 17, 23, 29, 30, 17
    30, 29, 28, 13, 31, 25, 18, 26, 22, 21, 30, 14, 29, 27, 27, 24, 30, 16, 19, 30, 28, 16, 14, 17, 31, 28, 29, 23, 17, 30, 23, 24, 31, 21, 13, 27, 26, 24, 24, 30, 25, 31, 31, 16, 16, 25, 23, 24, 16, 15
    27, 27, 24, 19, 22, 14, 18, 18, 17, 17, 31, 24, 23, 30, 26, 27, 17, 27, 26, 15, 27, 29, 24, 14, 17, 26, 21, 29, 26, 19, 25, 15, 17, 15, 28, 28, 28, 26, 21, 22, 24, 30, 29, 21, 29, 15, 28, 26, 24, 31
    27, 21, 26, 17, 24, 24, 19, 28, 20, 29, 14, 20, 24, 31, 19, 28, 20, 20, 13, 26, 20, 25, 14, 24, 20, 24, 30, 19, 15, 16, 13, 27, 16, 22, 21, 29, 25, 22, 24, 26, 20, 23, 24, 29, 31, 31, 29, 21, 29, 28
    26, 14, 19, 29, 28, 13, 27, 17, 23, 14, 31, 23, 29, 31, 25, 18, 21, 18, 25, 17, 18, 29, 19, 15, 15, 26, 29, 23, 27, 31, 17, 25, 21, 30, 20, 25, 24, 23, 18, 30, 17, 16, 13, 17, 21, 29, 21, 28, 15, 15
    31, 18, 17, 17, 30, 13, 31, 15, 13, 16, 15, 24, 30, 15, 13, 17, 26, 29, 31, 16, 29, 29, 24, 27, 31, 30, 21, 23, 29, 20, 25, 17, 13, 15, 24, 22, 24, 29, 18, 26, 25, 31, 23, 24, 30, 31, 27, 16, 15, 27
    16, 25, 26, 21, 13, 24, 13, 18, 26, 26, 31, 26, 26, 19, 21, 26, 23, 17, 23, 13, 21, 21, 21, 17, 26, 30, 29, 22, 24, 30, 28, 15, 16, 16, 20, 20, 14, 20, 18, 18, 19, 16, 19, 21, 24, 31, 28, 31, 25, 18
    18, 15, 30, 16, 23, 25, 19, 31, 14, 25, 16, 20, 30, 18, 14, 16, 28, 31, 27, 26, 24, 25, 17, 14, 13, 14, 20, 28, 13, 23, 31, 17, 26, 25, 18, 22, 17, 16, 28, 15, 26, 15, 17, 13, 13, 30, 25, 13, 17, 14
    14, 31, 26, 24, 16, 24, 28, 19, 25, 22, 27, 27, 17, 21, 16, 14, 29, 17, 20, 23, 23, 18, 19, 16, 17, 16, 23, 28, 24, 29, 23, 13, 15, 22, 19, 25, 24, 21, 17, 15, 27, 21, 25, 26, 28, 17, 13, 17, 13, 28
    25, 16, 14, 21, 21, 14, 22, 26, 31, 19, 22, 30, 13, 17, 15, 24, 24, 16, 30, 14, 17, 23, 28, 26, 29, 31, 17, 29, 17, 13, 29, 24, 31, 20, 21, 27, 31, 30, 20, 19, 24, 25, 18, 28, 26, 26, 22, 19, 24, 17
    21, 21, 25, 20, 20, 13, 15, 30, 15, 15, 25, 29, 19, 31, 14, 13, 28, 17, 20, 24, 26, 19, 31, 27, 18, 17, 24, 14, 21, 17, 23, 15, 30, 24, 20, 31, 14, 21, 24, 29, 14, 29, 14, 20, 26, 15, 31, 18, 31, 16
    19, 19, 17, 20, 28, 23, 25, 29, 16, 26, 28, 28, 23, 21, 19, 26, 27, 18, 24, 15, 29, 23, 16, 30, 16, 20, 15, 24, 26, 29, 27, 15, 20, 14, 13, 22, 19, 15, 23, 16, 19, 22, 31, 18, 27, 25, 26, 20, 18, 26
    31, 22, 27, 28, 22, 24, 30, 22, 21, 15, 21, 15, 18, 24, 28, 24, 31, 15, 13, 20, 16, 13, 27, 21, 19, 20, 26, 23, 21, 24, 13, 20, 15, 21, 26, 28, 31, 23, 23, 26, 14, 27, 15, 28, 16, 27, 15, 20, 25, 21
    20, 13, 16, 22, 24, 28, 21, 26, 18, 30, 31, 23, 15, 21, 23, 25, 14, 13, 28, 22, 15, 23, 25, 14, 23, 25, 20, 19, 14, 16, 27, 26, 16, 23, 31, 23, 24, 13, 20, 24, 27, 26, 13, 26, 21, 27, 24, 26, 23, 19
    22, 18, 20, 25, 27, 15, 13, 19, 19, 29, 15, 16, 25, 20, 20, 29, 20, 25, 24, 13, 30, 16, 24, 27, 29, 16, 22, 31, 20, 24, 26, 20, 29, 19, 15, 14, 18, 27, 15, 13, 14, 23, 19, 15, 14, 28, 30, 25, 28, 27
    17, 22, 17, 13, 23, 26, 26, 28, 22, 14, 15, 31, 13, 25, 19, 13, 15, 26, 14, 13, 16, 13, 17, 24, 28, 29, 27, 20, 20, 16, 16, 18, 31, 20, 22, 20, 22, 20, 24, 24, 19, 15, 22, 28, 21, 15, 24, 28, 17, 19
    31, 23, 30, 22, 25, 28, 15, 30, 16, 25, 22, 23, 31, 20, 16, 26, 18, 31, 23, 31, 27, 13, 18, 30, 17, 22, 28, 30, 16, 18, 30, 19, 16, 14, 26, 22, 20, 27, 14, 26, 26, 23, 28, 15, 26, 17, 25, 29, 23, 16
    29, 28, 23, 15, 23, 22, 24, 17, 15, 24, 17, 31, 31, 18, 31, 22, 22, 30, 17, 28, 29, 13, 16, 17, 15, 21, 20, 21, 19, 25, 21, 20, 26, 16, 25, 23, 21, 29, 18, 14, 13, 26, 29, 17, 28, 27, 27, 30, 16, 19
    27, 14, 15, 13, 16, 31, 24, 25, 29, 18, 13, 15, 29, 30, 24, 13, 19, 19, 21, 28, 22, 13, 14, 26, 26, 17, 29, 23, 25, 14, 26, 25, 22, 26, 16, 23, 18, 18, 25, 31, 18, 19, 30, 19, 18, 19, 31, 15, 17, 18
    28, 29, 21, 21, 27, 25, 29, 28, 26, 27, 26, 15, 31, 18, 28, 22, 23, 31, 13, 13, 22, 15, 15, 21, 20, 22, 20, 19, 28, 19, 19, 18, 31, 14, 26, 27, 18, 30, 23, 26, 28, 25, 20, 21, 23, 20, 31, 29, 29, 18
    15, 16, 13, 16, 24, 30, 21, 25, 17, 13, 29, 22, 24, 16, 14, 27, 28, 23, 28, 31, 18, 19, 17, 29, 13, 22, 26, 17, 22, 27, 13, 21, 15, 21, 13, 23, 21, 19, 13, 22, 15, 14, 14, 28, 13, 18, 14, 19, 24, 30
    16, 23, 31, 27, 14, 31, 13, 21, 24, 22, 25, 19, 25, 25, 19, 15, 18, 26, 21, 13, 20, 30, 23, 22, 26, 17, 22, 17, 15, 28, 30, 18, 19, 19, 13, 24, 31, 23, 24, 24, 28, 20, 19, 16, 29, 31, 25, 14, 19, 27
    31, 17, 24, 17, 31, 28, 21, 24, 19, 16, 15, 19, 18, 14, 26, 19, 18, 31, 26, 21, 17, 18, 19, 14, 31, 24, 30, 31, 19, 19, 23, 21, 23, 14, 21, 18, 31, 18, 27, 30, 29, 18, 29, 15, 24, 29, 19, 22, 14, 28
    14, 28, 21, 15, 26, 22, 20, 23, 17, 22, 30, 29, 17, 17, 16, 22, 24, 21, 22, 23, 29, 24, 16, 20, 15, 13, 15, 23, 19, 15, 22, 27, 25, 22, 27, 15, 17, 16, 31, 18, 30, 16, 21, 20, 29, 25, 28, 18, 19, 27
    24, 14, 20, 25, 26, 15, 13, 27, 27, 30, 13, 14, 15, 15, 20, 27, 19, 16, 31, 28, 17, 29, 14, 27, 18, 19, 24, 20, 22, 16, 19, 31, 20, 24, 22, 16, 19, 27, 24, 22, 29, 14, 22, 28, 21, 29, 30, 16, 20, 17

}

layer = {

63, 63, 63, 63, 63, 63, 38, 98, 0, 0, 0, 0, 0, 0, 0, 0, 0, 0, 0, 0, 0, 0, 0, 0, 0, 0, 0, 0, 0, 0, 0, 0, 0, 0, 0, 0, 0, 0, 0, 0, 0, 0, 0, 0, 0, 0, 0, 0, 0, 0
63, 63, 63, 63, 63, 63, 38, 0, 0, 0, 0, 0, 0, 0, 0, 0, 0, 0, 0, 0, 0, 0, 0, 0, 0, 0, 0, 0, 0, 0, 0, 0, 0, 0, 0, 0, 0, 0, 0, 0, 0, 0, 0, 0, 0, 0, 0, 0, 0, 0
63, 63, 45, 63, 63, 63, 38, 0, 0, 0, 0, 0, 0, 0, 0, 0, 0, 0, 0, 0, 0, 0, 0, 0, 0, 0, 0, 0, 0, 0, 0, 0, 0, 130, 0, 0, 0, 0, 0, 0, 0, 0, 0, 0, 0, 0, 0, 0, 0, 0
63, 63, 63, 63, 63, 63, 38, 98, 0, 0, 0, 0, 0, 0, 0, 0, 0, 0, 0, 0, 0, 0, 0, 0, 0, 0, 0, 0, 0, 0, 0, 0, 0, 0, 0, 0, 0, 0, 0, 0, 0, 0, 0, 0, 0, 0, 0, 0, 0, 0
63, 63, 63, 63, 63, 63, 38, 98, 99, 0, 0, 0, 0, 0, 0, 0, 0, 0, 0, 0, 0, 0, 0, 0, 0, 0, 0, 0, 0, 0, 0, 0, 0, 0, 0, 0, 0, 0, 0, 0, 0, 0, 0, 0, 0, 0, 0, 0, 0, 0
63, 63, 63, 63, 63, 63, 38, 98, 0, 0, 0, 0, 0, 0, 0, 0, 0, 0, 0, 0, 0, 0, 0, 0, 0, 0, 0, 0, 0, 0, 0, 147, 142, 0, 0, 0, 0, 0, 0, 0, 0, 0, 0, 0, 0, 0, 0, 0, 0, 0
63, 63, 63, 63, 63, 63, 38, 98, 0, 0, 0, 0, 0, 0, 0, 0, 0, 0, 0, 0, 0, 0, 0, 0, 0, 0, 0, 0, 0, 0, 0, 136, 146, 138, 0, 0, 0, 0, 0, 0, 0, 0, 0, 0, 0, 0, 0, 0, 0, 0
63, 63, 63, 63, 63, 63, 38, 98, 99, 0, 0, 0, 0, 0, 0, 0, 0, 0, 0, 0, 0, 0, 0, 0, 0, 0, 0, 0, 0, 0, 0, 0, 0, 145, 0, 0, 0, 0, 0, 0, 0, 0, 0, 0, 0, 0, 0, 0, 0, 0
63, 63, 63, 63, 63, 63, 38, 98,  0, 0, 0, 0, 0, 0, 0, 0, 0, 0, 0, 0, 0, 0, 0, 0, 0, 0, 0, 0, 0, 0, 0, 0, 0, 129, 144, 0, 0, 0, 0, 0, 0, 0, 0, 0, 0, 0, 0, 0, 0, 0
63, 63, 63, 63, 63, 63, 38, 0, 0, 0, 0, 0, 0, 0, 0, 0, 0, 0, 0, 0, 0, 0, 0, 0, 0, 0, 0, 0, 0, 0, 0, 0, 0, 0, 0, 0, 0, 0, 0, 0, 0, 0, 0, 0, 0, 0, 0, 0, 0, 0
39, 39, 39, 39, 39, 39, 35, 0, 0, 0, 0, 0, 0, 0, 0, 0, 0, 0, 0, 0, 0, 0, 0, 0, 0, 0, 0, 0, 0, 0, 0, 0, 0, 0, 0, 0, 0, 0, 0, 0, 0, 0, 0, 0, 0, 0, 0, 0, 0, 0
96, 96, 0, 96, 0, 0, 0, 0, 0, 0, 0, 0, 0, 0, 0, 0, 0, 0, 0, 0, 0, 0, 0, 0, 0, 0, 0, 0, 0, 0, 0, 0, 0, 0, 0, 0, 0, 0, 0, 0, 0, 0, 0, 0, 0, 0, 0, 0, 0, 0
0, 0, 0, 0, 0, 0, 0, 0, 0, 0, 0, 0, 0, 0, 0, 0, 0, 0, 0, 0, 0, 0, 0, 0, 0, 0, 0, 0, 0, 0, 0, 0, 0, 0, 0, 0, 0, 0, 0, 0, 0, 0, 0, 0, 0, 0, 0, 0, 0, 0
0, 0, 0, 0, 0, 0, 0, 0, 0, 0, 0, 0, 0, 0, 0, 0, 0, 0, 0, 0, 0, 0, 0, 0, 0, 0, 0, 0, 0, 0, 0, 0, 0, 0, 0, 0, 0, 0, 0, 0, 0, 0, 0, 0, 0, 0, 0, 0, 0, 0
0, 0, 0, 0, 0, 0, 0, 0, 0, 0, 0, 0, 0, 0, 0, 0, 0, 0, 0, 0, 0, 0, 0, 0, 0, 0, 0, 0, 0, 0, 0, 0, 0, 0, 0, 0, 0, 0, 0, 0, 0, 0, 0, 0, 0, 0, 0, 0, 0, 0
0, 0, 0, 0, 0, 0, 0, 0, 0, 0, 0, 0, 0, 0, 0, 0, 0, 0, 0, 0, 0, 0, 0, 0, 0, 0, 0, 0, 0, 0, 0, 0, 0, 0, 0, 0, 0, 0, 0, 0, 0, 0, 0, 0, 0, 0, 0, 0, 0, 0
0, 0, 0, 0, 0, 0, 0, 0, 0, 0, 0, 0, 0, 0, 0, 0, 0, 0, 0, 0, 0, 0, 0, 0, 0, 0, 0, 0, 0, 0, 0, 0, 0, 0, 0, 0, 0, 0, 0, 0, 0, 0, 0, 0, 0, 0, 0, 0, 0, 0
0, 0, 0, 0, 0, 0, 0, 0, 0, 0, 0, 0, 0, 0, 0, 0, 0, 0, 0, 0, 0, 0, 0, 0, 0, 0, 0, 0, 0, 0, 0, 0, 0, 0, 0, 0, 0, 0, 0, 0, 0, 0, 0, 0, 0, 0, 0, 0, 0, 0
0, 0, 0, 0, 0, 0, 0, 0, 0, 0, 0, 0, 0, 0, 0, 0, 0, 0, 0, 0, 0, 0, 0, 0, 0, 0, 0, 0, 0, 0, 0, 0, 0, 0, 0, 0, 0, 0, 0, 0, 0, 0, 0, 0, 0, 0, 0, 0, 0, 0
0, 0, 0, 0, 0, 0, 0, 0, 0, 0, 0, 0, 0, 0, 0, 0, 0, 0, 0, 0, 0, 0, 0, 0, 0, 0, 0, 0, 0, 0, 0, 0, 0, 0, 0, 0, 0, 0, 0, 0, 0, 0, 0, 0, 0, 0, 0, 0, 0, 0
0, 0, 0, 0, 0, 0, 0, 0, 0, 0, 0, 0, 0, 0, 0, 0, 0, 0, 0, 0, 0, 0, 0, 0, 0, 0, 0, 0, 0, 0, 0, 0, 0, 0, 0, 0, 0, 0, 0, 0, 0, 0, 0, 0, 0, 0, 0, 0, 0, 0
0, 0, 0, 0, 0, 0, 0, 0, 0, 0, 0, 0, 0, 0, 0, 0, 0, 0, 0, 0, 0, 0, 0, 0, 0, 0, 0, 0, 0, 0, 0, 0, 0, 0, 0, 0, 0, 0, 0, 0, 0, 0, 0, 0, 0, 0, 0, 0, 0, 0
0, 0, 0, 0, 0, 0, 0, 0, 0, 0, 0, 0, 0, 0, 0, 0, 0, 0, 0, 0, 0, 0, 0, 0, 0, 0, 0, 0, 0, 0, 0, 0, 0, 0, 0, 0, 0, 0, 0, 0, 0, 0, 0, 0, 0, 0, 0, 0, 0, 0
0, 0, 0, 0, 0, 0, 0, 0, 0, 0, 0, 0, 0, 0, 0, 0, 0, 0, 0, 0, 0, 0, 0, 0, 0, 0, 0, 0, 0, 0, 0, 0, 0, 0, 0, 0, 0, 0, 0, 0, 0, 0, 0, 0, 0, 0, 0, 0, 0, 0
0, 0, 0, 0, 0, 0, 0, 0, 0, 0, 0, 0, 0, 0, 0, 0, 0, 0, 0, 0, 0, 0, 0, 0, 0, 0, 0, 0, 0, 0, 0, 0, 0, 0, 0, 0, 0, 0, 0, 0, 0, 0, 0, 0, 0, 0, 0, 0, 0, 0
0, 0, 0, 0, 0, 0, 0, 0, 0, 0, 0, 0, 0, 0, 0, 0, 0, 0, 0, 0, 0, 0, 0, 0, 0, 0, 0, 0, 0, 0, 0, 0, 0, 0, 0, 0, 0, 0, 0, 0, 0, 0, 0, 0, 0, 0, 0, 0, 0, 0
0, 0, 0, 0, 0, 0, 0, 0, 0, 0, 0, 0, 0, 0, 0, 0, 0, 0, 0, 0, 0, 0, 0, 0, 0, 0, 0, 0, 0, 0, 0, 0, 0, 0, 0, 0, 0, 0, 0, 0, 0, 0, 0, 0, 0, 0, 0, 0, 0, 0
0, 0, 0, 0, 0, 0, 0, 0, 0, 0, 0, 0, 0, 0, 0, 0, 0, 0, 0, 0, 0, 0, 0, 0, 0, 0, 0, 0, 0, 0, 0, 0, 0, 0, 0, 0, 0, 0, 0, 0, 0, 0, 0, 0, 0, 0, 0, 0, 0, 0
0, 0, 0, 0, 0, 0, 0, 0, 0, 0, 0, 0, 0, 0, 0, 0, 0, 0, 0, 0, 0, 0, 0, 0, 0, 0, 0, 0, 0, 0, 0, 0, 0, 0, 0, 0, 0, 0, 0, 0, 0, 0, 0, 0, 0, 0, 0, 0, 0, 0
0, 0, 0, 0, 0, 0, 0, 0, 0, 0, 0, 0, 0, 0, 0, 0, 0, 0, 0, 0, 0, 0, 0, 0, 0, 0, 0, 0, 0, 0, 0, 0, 0, 0, 0, 0, 0, 0, 0, 0, 0, 0, 0, 0, 0, 0, 0, 0, 0, 0
0, 0, 0, 0, 0, 0, 0, 0, 0, 0, 0, 0, 0, 0, 0, 0, 0, 0, 0, 0, 0, 0, 0, 0, 0, 0, 0, 0, 0, 0, 0, 0, 0, 0, 0, 0, 0, 0, 0, 0, 0, 0, 0, 0, 0, 0, 0, 0, 0, 0
0, 0, 0, 0, 0, 0, 0, 0, 0, 0, 0, 0, 0, 0, 0, 0, 0, 0, 0, 0, 0, 0, 0, 0, 0, 0, 0, 0, 0, 0, 0, 0, 0, 0, 0, 0, 0, 0, 0, 0, 0, 0, 0, 0, 0, 0, 0, 0, 0, 0
0, 0, 0, 0, 0, 0, 0, 0, 0, 0, 0, 0, 0, 0, 0, 0, 0, 0, 0, 0, 0, 0, 0, 0, 0, 0, 0, 0, 0, 0, 0, 0, 0, 0, 0, 0, 0, 0, 0, 0, 0, 0, 0, 0, 0, 0, 0, 0, 0, 0
0, 0, 0, 0, 0, 0, 0, 0, 0, 0, 0, 0, 0, 0, 0, 0, 0, 0, 0, 0, 0, 0, 0, 0, 0, 0, 0, 0, 0, 0, 0, 0, 0, 0, 0, 0, 0, 0, 0, 0, 0, 0, 0, 0, 0, 0, 0, 0, 0, 0
0, 0, 0, 0, 0, 0, 0, 0, 0, 0, 0, 0, 0, 0, 0, 0, 0, 0, 0, 0, 0, 0, 0, 0, 0, 0, 0, 0, 0, 0, 0, 0, 0, 0, 0, 0, 0, 0, 0, 0, 0, 0, 0, 0, 0, 0, 0, 0, 0, 0
0, 0, 0, 0, 0, 0, 0, 0, 0, 0, 0, 0, 0, 0, 0, 0, 0, 0, 0, 0, 0, 0, 0, 0, 0, 0, 0, 0, 0, 0, 0, 0, 0, 0, 0, 0, 0, 0, 0, 0, 0, 0, 0, 0, 0, 0, 0, 0, 0, 0
0, 0, 0, 0, 0, 0, 0, 0, 0, 0, 0, 0, 0, 0, 0, 0, 0, 0, 0, 0, 0, 0, 0, 0, 0, 0, 0, 0, 0, 0, 0, 0, 0, 0, 0, 0, 0, 0, 0, 0, 0, 0, 0, 0, 0, 0, 0, 0, 0, 0
0, 0, 0, 0, 0, 0, 0, 0, 0, 0, 0, 0, 0, 0, 0, 0, 0, 0, 0, 0, 0, 0, 0, 0, 0, 0, 0, 0, 0, 0, 0, 0, 0, 0, 0, 0, 0, 0, 0, 0, 0, 0, 0, 0, 0, 0, 0, 0, 0, 0
0, 0, 0, 0, 0, 0, 0, 0, 0, 0, 0, 0, 0, 0, 0, 0, 0, 0, 0, 0, 0, 0, 0, 0, 0, 0, 0, 0, 0, 0, 0, 0, 0, 0, 0, 0, 0, 0, 0, 0, 0, 0, 0, 0, 0, 0, 0, 0, 0, 0
0, 0, 0, 0, 0, 0, 0, 0, 0, 0, 0, 0, 0, 0, 0, 0, 0, 0, 0, 0, 0, 0, 0, 0, 0, 0, 0, 0, 0, 0, 0, 0, 0, 0, 0, 0, 0, 0, 0, 0, 0, 0, 0, 0, 0, 0, 0, 0, 0, 0
0, 0, 0, 0, 0, 0, 0, 0, 0, 0, 0, 0, 0, 0, 0, 0, 0, 0, 0, 0, 0, 0, 0, 0, 0, 0, 0, 0, 0, 0, 0, 0, 0, 0, 0, 0, 0, 0, 0, 0, 0, 0, 0, 0, 0, 0, 0, 0, 0, 0
0, 0, 0, 0, 0, 0, 0, 0, 0, 0, 0, 0, 0, 0, 0, 0, 0, 0, 0, 0, 0, 0, 0, 0, 0, 0, 0, 0, 0, 0, 0, 0, 0, 0, 0, 0, 0, 0, 0, 0, 0, 0, 0, 0, 0, 0, 0, 0, 0, 0
0, 0, 0, 0, 0, 0, 0, 0, 0, 0, 0, 0, 0, 0, 0, 0, 0, 0, 0, 0, 0, 0, 0, 0, 0, 0, 0, 0, 0, 0, 0, 0, 0, 0, 0, 0, 0, 0, 0, 0, 0, 0, 0, 0, 0, 0, 0, 0, 0, 0
0, 0, 0, 0, 0, 0, 0, 0, 0, 0, 0, 0, 0, 0, 0, 0, 0, 0, 0, 0, 0, 0, 0, 0, 0, 0, 0, 0, 0, 0, 0, 0, 0, 0, 0, 0, 0, 0, 0, 0, 0, 0, 0, 0, 0, 0, 0, 0, 0, 0
0, 0, 0, 0, 0, 0, 0, 0, 0, 0, 0, 0, 0, 0, 0, 0, 0, 0, 0, 0, 0, 0, 0, 0, 0, 0, 0, 0, 0, 0, 0, 0, 0, 0, 0, 0, 0, 0, 0, 0, 0, 0, 0, 0, 0, 0, 0, 0, 0, 0
0, 0, 0, 0, 0, 0, 0, 0, 0, 0, 0, 0, 0, 0, 0, 0, 0, 0, 0, 0, 0, 0, 0, 0, 0, 0, 0, 0, 0, 0, 0, 0, 0, 0, 0, 0, 0, 0, 0, 0, 0, 0, 0, 0, 0, 0, 0, 0, 0, 0
0, 0, 0, 0, 0, 0, 0, 0, 0, 0, 0, 0, 0, 0, 0, 0, 0, 0, 0, 0, 0, 0, 0, 0, 0, 0, 0, 0, 0, 0, 0, 0, 0, 0, 0, 0, 0, 0, 0, 0, 0, 0, 0, 0, 0, 0, 0, 0, 0, 0
0, 0, 0, 0, 0, 0, 0, 0, 0, 0, 0, 0, 0, 0, 0, 0, 0, 0, 0, 0, 0, 0, 0, 0, 0, 0, 0, 0, 0, 0, 0, 0, 0, 0, 0, 0, 0, 0, 0, 0, 0, 0, 0, 0, 0, 0, 0, 0, 0, 0
0, 0, 0, 0, 0, 0, 0, 0, 0, 0, 0, 0, 0, 0, 0, 0, 0, 0, 0, 0, 0, 0, 0, 0, 0, 0, 0, 0, 0, 0, 0, 0, 0, 0, 0, 0, 0, 0, 0, 0, 0, 0, 0, 0, 0, 0, 0, 0, 0, 0
0, 0, 0, 0, 0, 0, 0, 0, 0, 0, 0, 0, 0, 0, 0, 0, 0, 0, 0, 0, 0, 0, 0, 0, 0, 0, 0, 0, 0, 0, 0, 0, 0, 0, 0, 0, 0, 0, 0, 0, 0, 0, 0, 0, 0, 0, 0, 0, 0, 0
0, 0, 0, 0, 0, 0, 0, 0, 0, 0, 0, 0, 0, 0, 0, 0, 0, 0, 0, 0, 0, 0, 0, 0, 0, 0, 0, 0, 0, 0, 0, 0, 0, 0, 0, 0, 0, 0, 0, 0, 0, 0, 0, 0, 0, 0, 0, 0, 0, 0
0, 0, 0, 0, 0, 0, 0, 0, 0, 0, 0, 0, 0, 0, 0, 0, 0, 0, 0, 0, 0, 0, 0, 0, 0, 0, 0, 0, 0, 0, 0, 0, 0, 0, 0, 0, 0, 0, 0, 0, 0, 0, 0, 0, 0, 0, 0, 0, 0, 0
0, 0, 0, 0, 0, 0, 0, 0, 0, 0, 0, 0, 0, 0, 0, 0, 0, 0, 0, 0, 0, 0, 0, 0, 0, 0, 0, 0, 0, 0, 0, 0, 0, 0, 0, 0, 0, 0, 0, 0, 0, 0, 0, 0, 0, 0, 0, 0, 0, 0

}
