tileWidth = 64
tileHeight = 64
tileset = "basic-64x64.png"
resources = "flatland.res"


layer = {
    18, 26, 16, 15, 21, 26, 21, 23, 21, 21, 18, 24, 24, 26, 27, 25, 29, 20, 22, 22, 20, 15, 19, 16, 21
    26, 16, 27, 20, 19, 19, 23, 29, 29, 19, 25, 28, 25, 28, 22, 27, 15, 27, 16, 22, 17, 27, 24, 15, 18
    27, 18, 23, 27, 26, 25, 24, 25, 26, 21, 21, 20, 24, 15, 24, 28, 16, 24, 17, 22, 28, 15, 26, 21, 26
    29, 16, 22, 24, 21, 24, 18, 27, 24, 17, 16, 17, 17, 21, 27, 23, 17, 23, 24, 23, 15, 20, 28, 28, 23
    23, 17, 21, 28, 24, 15, 24, 26, 21, 16, 25, 28, 24, 15, 20, 22, 23, 23, 17, 25, 28, 27, 26, 20, 24
    20, 15, 28, 23, 24, 25, 24, 18, 18, 20, 27, 23, 24, 25, 19, 29, 20, 19, 23, 23, 27, 17, 26, 22, 28
    20, 23, 28, 17, 25, 20, 17, 27, 20, 15, 24, 17, 28, 19, 21, 24, 23, 25, 23, 29, 25, 23, 28, 26, 23
    29, 25, 21, 19, 20, 15, 22, 24, 23, 29, 19, 19, 18, 20, 17, 18, 23, 21, 17, 16, 19, 15, 26, 19, 20
    20, 25, 26, 21, 22, 29, 26, 22, 21, 18, 27, 24, 22, 20, 25, 27, 17, 23, 23, 24, 15, 17, 29, 29, 25
    29, 16, 28, 25, 23, 19, 19, 22, 29, 27, 27, 26, 19, 16, 21, 27, 16, 27, 21, 18, 28, 21, 19, 19, 16
    21, 22, 26, 29, 26, 23, 26, 16, 16, 24, 17, 16, 20, 15, 27, 19, 16, 20, 16, 24, 20, 24, 15, 27, 18
    26, 25, 20, 26, 23, 20, 22, 19, 19, 29, 21, 18, 15, 27, 15, 25, 22, 26, 15, 27, 15, 15, 19, 25, 19
    21, 28, 24, 29, 20, 15, 15, 23, 18, 17, 28, 24, 17, 19, 23, 29, 20, 25, 24, 28, 19, 22, 23, 21, 27
    25, 27, 22, 21, 21, 24, 19, 16, 20, 22, 29, 25, 29, 19, 21, 21, 21, 24, 23, 15, 23, 21, 25, 17, 18
    15, 21, 26, 23, 17, 28, 18, 29, 17, 24, 23, 26, 28, 22, 16, 25, 28, 18, 26, 18, 24, 23, 18, 21, 29
    16, 27, 17, 21, 17, 27, 18, 19, 21, 21, 18, 27, 29, 21, 15, 19, 22, 16, 26, 28, 17, 20, 27, 17, 18
    22, 19, 17, 15, 19, 21, 20, 22, 21, 29, 15, 26, 23, 16, 29, 26, 24, 16, 29, 22, 20, 16, 24, 26, 22
    20, 21, 27, 17, 28, 22, 20, 25, 25, 27, 25, 22, 25, 29, 20, 20, 20, 24, 25, 21, 15, 29, 29, 22, 16
    27, 20, 19, 16, 15, 19, 28, 17, 25, 28, 22, 22, 26, 21, 22, 21, 26, 24, 18, 23, 20, 15, 27, 18, 16
    20, 22, 26, 15, 17, 25, 22, 24, 28, 21, 29, 21, 24, 18, 25, 22, 25, 19, 24, 23, 27, 19, 23, 27, 19
    15, 22, 17, 18, 25, 17, 20, 27, 27, 21, 29, 21, 20, 23, 28, 23, 16, 24, 17, 19, 25, 27, 21, 20, 27
    21, 26, 18, 28, 28, 29, 27, 15, 26, 23, 15, 22, 19, 29, 29, 25, 19, 23, 25, 28, 29, 24, 25, 28, 18
    24, 21, 22, 19, 21, 26, 24, 16, 19, 29, 27, 28, 23, 20, 16, 20, 17, 20, 17, 17, 21, 29, 27, 26, 15
    29, 28, 18, 16, 24, 22, 27, 17, 20, 20, 22, 22, 20, 25, 20, 29, 17, 26, 21, 18, 29, 26, 15, 19, 26
    15, 26, 25, 16, 15, 16, 24, 25, 24, 20, 24, 27, 20, 28, 16, 15, 26, 27, 19, 16, 20, 19, 21, 16, 26
}

layer = {

    0, 0, 2,
    0, 3, 0

}
